user_id,top_ties,reciprocity,extrovert_score,num_circles,churn_rate,out_degree,in_degree,total_activity
0,"[(385, 3960), (158, 201.0), (162, 120), (362, 55.0)]",1.0,4.0,5,0.2682926829268293,4,4,8
1,"[(35, 291.0), (344, 241.0), (260, 104.0), (263, 90), (34, 39.0)]",0.8,3.75,6,0.0,5,4,9
2,"[(271, 6390), (36, 2250), (305, 398.0), (168, 369.0), (197, 243.0)]",0.7,7.883720930232558,8,0.39285714285714285,9,8,17
3,"[(205, 2640), (173, 810), (325, 510), (262, 210), (136, 150)]",0.8888888888888888,8.15625,6,0.0,9,8,17
4,"[(559, 960), (293, 269.0), (208, 210), (21, 113.0), (np.int64(433), 20.0)]",0.8,4.0,4,0.0,4,5,9
5,"[(22, 2070), (311, 330)]",1.0,2.0,2,0.0,2,2,4
6,"[(320, 450), (419, 369.0), (444, 180), (396, 54.0), (np.int64(300), 48.0)]",0.8,3.25,3,0.5714285714285714,4,5,9
7,"[(500, 30), (np.int64(9), 2.0)]",0.0,1.0,4,0.0,1,1,2
8,"[(349, 179.0), (181, 84.0), (10, 60), (np.int64(9), 54.0), (20, 29.0)]",0.6,3.36,3,0.0,4,4,8
9,"[(375, 3240), (412, 965.0), (10, 930), (355, 565.0), (20, 60)]",0.5555555555555556,8.058139534883722,7,0.20833333333333334,9,5,14
10,"[(375, 1800), (9, 930), (437, 630), (370, 150), (441, 150)]",0.8888888888888888,8.4375,8,0.0,9,8,17
11,"[(322, 810), (41, 155.0), (np.int64(75), 100.0), (np.int64(168), 88.0), (471, 68.0)]",0.42857142857142855,3.4761904761904763,7,0.0,4,6,10
12,"[(79, 600), (44, 180), (380, 150), (173, 60), (503, 30)]",0.6666666666666666,4.829268292682928,6,0.8333333333333334,6,4,10
13,"[(429, 2040), (371, 1440), (528, 36.0), (214, 30)]",0.75,4.0,3,0.375,4,3,7
14,"[(421, 3051.0), (33, 1102.0), (34, 540), (446, 210)]",0.75,3.5555555555555554,4,0.2,4,3,7
15,"[(16, 25597.0), (335, 630), (314, 2.0)]",0.6666666666666666,3.0,3,0.30857142857142855,3,2,5
16,"[(15, 25597.0)]",1.0,1.0,1,0.0,1,1,2
17,"[(485, 210), (467, 126.0), (np.int64(455), 65.0), (499, 60)]",0.75,3.0,3,0.0,3,4,7
18,"[(38, 2430), (37, 87.0), (369, 30)]",0.6666666666666666,3.0,3,0.0,3,2,5
19,"[(64, 510), (61, 279.0)]",1.0,2.0,3,0.0,2,2,4
20,"[(344, 510), (190, 210), (508, 121.0), (np.int64(181), 65.0), (9, 60)]",0.42857142857142855,3.1904761904761907,6,0.0,4,6,10
21,"[(185, 210), (4, 113.0), (268, 100.0)]",0.6666666666666666,3.0,3,0.0,3,2,5
22,"[(5, 2070), (284, 540), (261, 240), (255, 227.0), (461, 210)]",0.7142857142857143,7.0,5,0.47619047619047616,7,5,12
23,"[(242, 420), (np.int64(266), 30), (np.int64(57), 7.0), (np.int64(205), 7.0)]",0.25,1.0,4,0.875,1,4,5
24,"[(179, 206.0), (499, 173.0), (196, 90)]",1.0,3.0,4,0.0,3,3,6
25,"[(61, 270), (215, 240), (306, 30), (np.int64(31), 2.0)]",0.5,3.0,4,0.0,3,3,6
26,"[(27, 4951.0), (188, 3090), (362, 334.0), (289, 253.0), (531, 180)]",0.6666666666666666,5.7073170731707314,5,0.0,6,4,10
27,"[(26, 4951.0), (221, 604.0), (32, 480), (50, 340.0)]",1.0,3.3333333333333335,4,0.4,4,4,8
28,"[(29, 6090), (385, 2820), (307, 1590), (391, 1440), (346, 120)]",0.8333333333333334,5.5200000000000005,6,0.9565217391304348,6,5,11
29,"[(28, 6090), (435, 5312.0), (233, 1260), (54, 450), (np.int64(315), 176.0)]",0.875,6.7142857142857135,6,0.25806451612903225,7,8,15
30,"[(464, 3960), (91, 210), (198, 150), (328, 100.0), (530, 90)]",0.5,7.741935483870968,7,0.0,8,4,12
31,"[(328, 90), (25, 2.0)]",0.5,2.0,2,0.0,2,1,3
32,"[(33, 654.0), (27, 480), (np.int64(319), 2.0)]",0.6666666666666666,1.5,2,0.625,2,3,5
33,"[(319, 2220.0), (np.int64(14), 1102.0), (368, 690), (32, 654.0), (524, 600)]",0.8571428571428571,5.666666666666666,5,0.23076923076923078,6,7,13
34,"[(35, 4360.0), (340, 1740), (14, 540), (33, 120), (1, 39.0)]",0.7142857142857143,4.344262295081967,7,0.36,5,7,12
35,"[(36, 7830), (34, 4360.0), (260, 1121.0), (369, 330), (1, 291.0)]",0.875,6.571428571428572,7,0.0,7,8,15
36,"[(35, 7830), (2, 2250), (131, 1590), (271, 420), (59, 330)]",0.8571428571428571,5.666666666666666,5,0.0,6,7,13
37,"[(433, 270), (np.int64(56), 197.0), (464, 171.0), (18, 87.0)]",0.75,3.0,3,0.0,3,4,7
38,"[(18, 2430), (60, 1050), (np.int64(168), 142.0), (217, 81.0), (485, 79.0)]",0.15384615384615385,8.95631067961165,7,0.2,9,6,15
39,"[(228, 660), (173, 420), (358, 180.0), (273, 150), (246, 90)]",1.0,7.142857142857143,7,0.0,8,8,16
40,"[(206, 90), (208, 60), (np.int64(350), 33.0), (np.int64(222), 2.0), (np.int64(336), 2.0)]",0.4,1.5263157894736843,5,0.0,2,5,7
41,"[(385, 1200), (182, 330), (11, 155.0), (471, 110.0), (np.int64(168), 92.0)]",0.6,3.44,5,0.92,4,4,8
42,"[(382, 240), (311, 206.0), (np.int64(408), 15.0)]",0.3333333333333333,2.0,3,0.0,2,2,4
43,"[(124, 420), (376, 270), (266, 67.0), (np.int64(125), 30)]",0.5,1.1538461538461537,3,0.5555555555555556,3,3,6
44,"[(503, 480), (527, 320.0), (105, 270), (12, 180), (529, 120)]",0.8333333333333334,4.3,4,0.0,5,6,11
45,"[(332, 300), (433, 240), (np.int64(155), 54.0), (np.int64(66), 23.0), (np.int64(67), 3.0)]",0.4,1.8947368421052633,5,0.2857142857142857,2,5,7
46,"[(212, 1530), (np.int64(188), 70.0)]",0.5,1.0,2,0.0,1,2,3
47,"[(278, 330), (354, 153.0)]",1.0,2.0,2,1.0,2,2,4
48,"[(517, 863.0), (378, 510), (561, 180)]",1.0,2.0,3,0.0,3,3,6
49,"[(70, 630), (159, 300), (69, 90), (333, 37.0), (np.int64(421), 30)]",0.8,3.5,4,0.0,4,5,9
50,"[(27, 340.0), (221, 239.0), (199, 134.0), (197, 90), (141, 39.0)]",0.5,6.32258064516129,8,0.25,7,5,12
51,"[(np.int64(422), 130.0), (346, 60)]",0.5,1.0,3,0.0,1,2,3
52,"[(551, 1170), (420, 41.0)]",0.5,2.0,3,0.0,2,1,3
53,"[(357, 180), (246, 150), (54, 143.0)]",0.6666666666666666,3.0,3,0.0,3,2,5
54,"[(29, 450), (233, 180), (207, 150), (np.int64(53), 143.0), (144, 90)]",0.8571428571428571,5.333333333333333,6,0.0,6,7,13
55,"[(448, 480), (332, 43.0), (35, 14.0)]",0.6666666666666666,3.0,5,1.0,3,2,5
56,"[(37, 197.0), (np.int64(168), 152.0), (445, 90)]",0.3333333333333333,2.0,6,0.0,2,2,4
57,"[(273, 240), (114, 90), (np.int64(416), 41.0), (23, 7.0)]",0.5,3.0,5,0.0,3,3,6
58,"[(103, 840), (89, 531.0), (162, 30), (152, 10.0)]",0.75,4.0,4,0.0,4,3,7
59,"[(169, 540), (36, 330), (np.int64(505), 71.0)]",0.6666666666666666,2.0,4,0.0,2,3,5
60,"[(38, 1050), (118, 780), (261, 90), (486, 60), (271, 36.0)]",0.8,5.0,7,0.0,5,4,9
61,"[(441, 930), (19, 279.0), (25, 270)]",1.0,3.0,4,0.0,3,3,6
62,"[(156, 750), (np.int64(167), 61.0)]",0.5,1.0,2,0.9230769230769231,1,2,3
63,"[(317, 1646.0), (80, 431.0), (np.int64(471), 239.0), (np.int64(349), 30)]",0.5,1.2307692307692308,4,0.0,2,4,6
64,"[(19, 510), (273, 220.0), (406, 187.0), (187, 82.0), (234, 22.0)]",0.6666666666666666,4.536585365853659,5,0.0,6,4,10
65,"[(172, 90), (247, 69.0)]",1.0,2.0,2,0.0,2,2,4
66,"[(67, 6527.0), (261, 4306.0), (83, 1290), (387, 570), (338, 540)]",0.75,7.529411764705882,5,0.0,8,6,14
67,"[(66, 6527.0), (246, 570), (431, 300), (196, 180), (496, 120)]",0.75,6.4,6,0.0,8,6,14
68,"[(260, 540), (279, 136.0), (np.int64(194), 101.0), (403, 79.0), (np.int64(450), 67.0)]",0.5,2.5454545454545454,4,0.0,3,6,9
69,"[(70, 23370), (272, 750), (358, 600), (341, 587.0), (360, 480)]",0.8571428571428571,5.833333333333334,4,0.0,7,6,13
70,"[(69, 23370), (49, 630), (118, 271.0), (483, 180)]",1.0,3.3333333333333335,4,0.0,4,4,8
71,"[(448, 1012.0), (295, 810), (130, 348.0), (391, 261.0), (426, 180)]",0.6666666666666666,6.626262626262626,8,0.75,8,7,15
72,"[(366, 13440), (512, 477.0), (83, 332.0), (332, 124.0), (412, 5.0)]",0.5,6.0,4,0.0,6,3,9
73,"[(317, 510), (121, 270), (409, 101.0), (241, 89.0), (np.int64(105), 61.0)]",0.6,3.04,5,0.0,4,4,8
74,"[(414, 1410), (301, 1394.0), (351, 509.0), (477, 480), (132, 210)]",0.7777777777777778,7.566371681415929,5,0.64,9,7,16
75,"[(548, 1080), (147, 270), (85, 150), (11, 100.0), (np.int64(504), 76.0)]",0.4,6.477011494252874,6,0.18181818181818182,7,7,14
76,"[(107, 1200), (434, 630), (253, 210)]",1.0,2.0,2,0.375,3,3,6
77,"[(321, 480), (266, 421.0), (377, 180)]",1.0,2.0,2,0.3333333333333333,3,3,6
78,"[(211, 1811.0), (409, 210), (332, 60.0)]",0.3333333333333333,3.0,4,1.0,3,1,4
79,"[(170, 960), (537, 780), (137, 690), (12, 600), (427, 570)]",0.8333333333333334,10.30316742081448,8,0.1,11,11,22
80,"[(278, 3570), (317, 1241.0), (63, 431.0), (419, 180), (398, 64.0)]",0.6666666666666666,5.2682926829268295,4,0.0,6,4,10
81,"[(223, 6390), (213, 270), (286, 210), (94, 180), (307, 150)]",1.0,4.0,3,0.0,5,5,10
82,"[(135, 900), (101, 371.0), (522, 250.0), (np.int64(249), 30)]",0.5,3.0,5,0.5,3,3,6
83,"[(66, 1290), (224, 510.0), (72, 332.0), (323, 163.0), (338, 120)]",0.8333333333333334,4.4,5,0.0,5,6,11
84,"[(555, 600), (477, 208.0), (103, 150), (390, 150), (302, 146.0)]",0.6666666666666666,8.954545454545455,5,0.0,9,6,15
85,"[(236, 2880), (346, 300), (75, 150), (203, 60)]",1.0,3.0,5,0.0,4,4,8
86,"[(322, 180), (510, 180), (np.int64(272), 22.0)]",0.6666666666666666,2.0,3,0.3333333333333333,2,3,5
87,"[(np.int64(22), 30), (np.int64(9), 26.0)]",0.0,0.0,3,0.0,0,2,2
88,"[(288, 3480), (539, 450), (440, 372.0), (330, 79.0)]",1.0,3.6666666666666665,3,0.10714285714285714,4,4,8
89,"[(361, 3510), (58, 531.0)]",1.0,2.0,2,0.38095238095238093,2,2,4
90,"[(468, 720), (354, 330), (np.int64(532), 43.0)]",0.6666666666666666,2.0,3,0.0,2,3,5
91,"[(30, 210), (94, 191.0), (564, 90), (79, 64.0), (133, 54.0)]",0.8,4.53125,6,0.3333333333333333,5,4,9
92,"[(135, 4650), (95, 390), (228, 200.0), (np.int64(74), 30)]",0.75,2.3333333333333335,4,0.5,3,4,7
93,"[(240, 2610), (211, 2479.0), (393, 600)]",0.6666666666666666,1.5,3,0.5789473684210527,3,2,5
94,"[(223, 1350), (np.int64(91), 191.0), (81, 180), (558, 120), (133, 3.0)]",0.6,3.2,3,0.0,4,4,8
95,"[(135, 3390), (92, 390), (378, 39.0)]",1.0,2.0,3,0.0,3,3,6
96,"[(365, 210), (518, 150.0), (376, 120), (124, 60), (158, 47.0)]",0.4,4.473684210526316,3,0.6666666666666666,5,2,7
97,"[(151, 600), (415, 17.0), (322, 3.0)]",0.3333333333333333,3.0,3,0.0,3,1,4
98,"[(np.int64(207), 1042.0), (566, 450), (162, 270), (552, 150), (182, 120)]",0.5714285714285714,5.411764705882353,6,0.75,6,5,11
99,"[(505, 522.0), (440, 210), (345, 120), (219, 36.0), (np.int64(50), 17.0)]",0.6666666666666666,4.7560975609756095,5,0.0,5,5,10
100,"[(217, 720), (358, 90), (171, 30), (np.int64(426), 2.0)]",0.5,2.5384615384615383,5,0.0,3,3,6
101,"[(102, 9998.0), (538, 1500), (231, 1230), (184, 570), (np.int64(82), 371.0)]",0.625,5.342465753424658,5,0.0,6,7,13
102,"[(101, 9998.0), (np.int64(321), 486.0), (452, 120)]",0.6666666666666666,2.0,4,0.0,2,3,5
103,"[(104, 17910), (386, 2078.0), (58, 840), (488, 420), (84, 150)]",0.8333333333333334,6.0,6,0.11688311688311688,6,5,11
104,"[(103, 17910), (136, 600), (344, 150), (532, 105.0), (449, 90)]",0.7142857142857143,6.770491803278688,7,0.23170731707317074,7,5,12
105,"[(409, 4170), (44, 270), (np.int64(380), 120), (503, 90), (73, 61.0)]",0.5,2.787878787878788,5,0.0,4,5,9
106,"[(564, 930), (175, 480), (np.int64(353), 2.0)]",0.6666666666666666,2.0,2,0.0,2,3,5
107,"[(136, 5760), (76, 1200), (434, 360), (np.int64(325), 42.0), (225, 41.0)]",0.8,3.0,4,0.0,4,5,9
108,"[(399, 999.0), (349, 210), (237, 60), (2, 17.0), (219, 8.0)]",0.8,5.0,5,0.0,5,4,9
109,"[(110, 4451.0), (422, 2610), (318, 240), (231, 150), (3, 90)]",1.0,5.0,5,0.0,5,5,10
110,"[(109, 4451.0), (111, 900), (134, 170.0), (429, 4.0)]",0.5,4.0,5,0.9166666666666666,4,2,6
111,"[(347, 1290), (456, 1230), (136, 1020), (110, 900), (349, 716.0)]",1.0,4.5,2,0.043478260869565216,5,5,10
112,"[(375, 960), (318, 159.0), (np.int64(262), 11.0)]",0.6666666666666666,2.0,3,0.75,2,3,5
113,"[(492, 60), (np.int64(241), 23.0), (50, 5.0)]",0.0,2.0,3,0.0,2,1,3
114,"[(339, 3480), (292, 421.0), (57, 90), (482, 27.0)]",0.75,3.5555555555555554,4,0.0,4,3,7
115,"[(434, 2880), (430, 81.0), (54, 60)]",1.0,3.0,4,0.39285714285714285,3,3,6
116,"[(515, 3030), (310, 870), (254, 3.0)]",0.6666666666666666,1.5,3,0.2727272727272727,3,2,5
117,"[(457, 420), (510, 99.0), (372, 17.0)]",0.3333333333333333,3.0,3,0.0,3,1,4
118,"[(482, 861.0), (60, 780), (70, 271.0), (np.int64(296), 2.0)]",0.75,3.0,3,0.0,3,4,7
119,"[(481, 720), (np.int64(368), 371.0), (130, 60), (np.int64(541), 30)]",0.5,1.3846153846153846,4,0.375,2,4,6
120,"[(546, 1050), (530, 240), (394, 120), (np.int64(389), 60.0)]",0.75,2.6666666666666665,5,0.0,3,4,7
121,"[(515, 930), (73, 270), (317, 150)]",1.0,2.0,3,0.6666666666666666,3,3,6
122,"[(412, 390), (np.int64(222), 25.0)]",0.5,1.0,2,0.8,1,2,3
123,"[(np.int64(420), 30), (222, 11.0)]",0.0,1.0,2,0.0,1,1,2
124,"[(125, 1565.0), (43, 420), (376, 240), (234, 150), (np.int64(96), 60)]",0.8,1.5,5,0.0,4,5,9
125,"[(234, 5610), (124, 1565.0), (202, 784.0), (376, 690), (np.int64(344), 71.0)]",0.6666666666666666,3.048780487804878,6,0.46153846153846156,5,5,10
126,"[(127, 270), (549, 30), (np.int64(304), 23.0)]",0.3333333333333333,2.0,2,1.0,2,2,4
127,"[(369, 1650), (289, 900.0), (210, 870), (126, 270), (211, 100.0)]",0.8,4.84375,4,0.6666666666666666,5,4,9
128,"[(324, 180)]",1.0,1.0,1,0.0,1,1,2
129,"[(307, 360), (35, 215.0), (158, 133.0)]",0.6666666666666666,3.0,5,0.0,3,2,5
130,"[(448, 2326.0), (166, 1320), (565, 540), (71, 348.0), (119, 60)]",0.8571428571428571,5.083333333333333,5,0.21428571428571427,6,7,13
131,"[(36, 1590), (400, 809.0), (328, 406.0), (331, 390), (441, 92.0)]",0.8333333333333334,4.6000000000000005,6,0.0,5,6,11
132,"[(477, 6360), (493, 260.0), (74, 210), (np.int64(172), 99.0), (414, 60)]",0.8,2.5,4,0.0,4,5,9
133,"[(353, 480), (423, 270), (np.int64(79), 122.0), (164, 120), (91, 54.0)]",0.6666666666666666,3.707317073170732,5,0.6666666666666666,4,6,10
134,"[(409, 1880.0), (177, 540), (251, 390), (np.int64(110), 170.0), (525, 120)]",0.4444444444444444,5.837837837837839,6,0.0,6,7,13
135,"[(92, 4650), (95, 3390), (82, 900), (448, 180), (75, 34.0)]",0.8,4.375,6,0.0,5,4,9
136,"[(434, 52920), (107, 5760), (456, 1110), (111, 1020), (104, 600)]",0.7142857142857143,11.548872180451127,11,0.0,12,12,24
137,"[(79, 690), (537, 390), (np.int64(459), 117.0), (530, 78.0), (146, 35.0)]",0.42857142857142855,5.214285714285714,8,0.6363636363636364,6,4,10
138,"[(209, 2070), (400, 510), (515, 420), (210, 390), (np.int64(415), 283.0)]",0.5,3.967741935483871,7,0.25,4,8,12
139,"[(150, 3690), (489, 660), (562, 300), (369, 60), (np.int64(328), 5.0)]",0.6666666666666666,5.0,4,0.18518518518518517,5,5,10
140,"[(440, 1170), (159, 336.0), (259, 296.0), (np.int64(369), 90), (np.int64(318), 71.0)]",0.6,2.52,5,0.0,3,5,8
141,"[(221, 98.0), (np.int64(50), 39.0), (272, 30), (38, 6.0)]",0.25,2.3333333333333335,4,0.0,3,2,5
142,"[(513, 180), (353, 60), (np.int64(182), 53.0), (np.int64(472), 17.0)]",0.5,2.0,3,0.0,2,4,6
143,"[(269, 328.0), (289, 99.0), (np.int64(195), 60.0), (np.int64(270), 60), (np.int64(313), 30)]",0.1111111111111111,3.3636363636363638,8,0.0,4,6,10
144,"[(233, 360), (54, 90), (np.int64(535), 23.0)]",0.6666666666666666,1.0,3,0.7142857142857143,2,3,5
145,"[(548, 360), (np.int64(154), 41.0)]",0.5,1.0,2,0.6666666666666666,1,2,3
146,"[(191, 810), (504, 150), (np.int64(137), 35.0), (np.int64(143), 27.0)]",0.5,2.0,7,0.0,2,4,6
147,"[(285, 510), (75, 270), (307, 90), (216, 70.0), (np.int64(428), 60)]",0.5,4.0,6,0.3333333333333333,4,5,9
148,"[(np.int64(280), 70.0), (567, 60)]",0.5,1.0,2,0.0,1,2,3
149,"[(158, 1530), (171, 497.0), (518, 360)]",1.0,3.0,5,0.0,3,3,6
150,"[(139, 3690), (169, 660), (285, 240), (np.int64(316), 28.0)]",0.75,2.3333333333333335,4,0.4166666666666667,3,4,7
151,"[(228, 3480), (97, 600), (401, 180), (500, 103.0)]",1.0,4.0,3,0.043478260869565216,4,4,8
152,"[(296, 840), (58, 10.0)]",1.0,2.0,2,0.0,2,2,4
153,"[(177, 780), (176, 420), (489, 299.0)]",1.0,2.0,3,0.7142857142857143,3,3,6
154,"[(337, 120), (145, 41.0)]",0.5,2.0,2,0.0,2,1,3
155,"[(298, 750), (532, 360), (45, 54.0), (np.int64(398), 48.0)]",0.5,3.0,5,0.0,3,3,6
156,"[(62, 750), (307, 294.0)]",1.0,2.0,3,0.0,2,2,4
157,"[(521, 3060), (503, 252.0), (399, 193.0), (475, 73.0)]",0.75,3.111111111111111,5,0.07692307692307693,4,3,7
158,"[(149, 1530), (348, 754.0), (0, 201.0), (np.int64(129), 133.0), (442, 75.0)]",0.5,3.4838709677419355,6,0.0,4,8,12
159,"[(140, 336.0), (49, 300), (340, 151.0), (np.int64(259), 124.0)]",0.75,2.6666666666666665,4,0.4090909090909091,3,4,7
160,"[(178, 210), (503, 9.0)]",0.5,2.0,3,0.0,2,1,3
161,"[(535, 480), (422, 210), (287, 137.0)]",1.0,2.0,2,0.0,3,3,6
162,"[(339, 1320), (374, 540), (98, 270), (308, 157.0), (0, 120)]",0.8571428571428571,5.666666666666666,6,0.35714285714285715,6,7,13
163,"[(313, 240), (270, 180), (np.int64(487), 17.0)]",0.6666666666666666,2.0,3,0.25,2,3,5
164,"[(495, 210), (133, 120), (np.int64(195), 62.0), (np.int64(385), 30), (289, 10.0)]",0.3333333333333333,2.8846153846153846,7,1.0,3,5,8
165,"[(277, 1330.0), (305, 720), (np.int64(510), 38.0)]",0.6666666666666666,2.0,3,0.75,2,3,5
166,"[(130, 1320)]",1.0,1.0,2,0.2857142857142857,1,1,2
167,"[(327, 570), (263, 145.0), (271, 144.0), (np.int64(326), 72.0), (62, 61.0)]",0.3333333333333333,5.0,5,0.0,5,3,8
168,"[(np.int64(276), 375.0), (2, 369.0), (197, 188.0), (195, 153.0), (56, 152.0)]",0.2777777777777778,14.580645161290322,12,0.2857142857142857,16,7,23
169,"[(150, 660), (59, 540), (333, 338.0), (285, 180), (2, 180)]",0.8571428571428571,5.666666666666666,6,0.0,6,7,13
170,"[(293, 10560), (546, 1770), (79, 960), (np.int64(104), 30.0)]",0.75,3.0,4,0.5056179775280899,3,4,7
171,"[(244, 1120.0), (407, 561.0), (149, 497.0), (368, 90.0), (310, 87.0)]",0.6666666666666666,4.51219512195122,5,0.0,5,5,10
172,"[(351, 480), (274, 120), (132, 99.0), (65, 90), (np.int64(310), 3.0)]",0.6,4.0,4,0.7142857142857143,4,4,8
173,"[(246, 1500), (3, 810), (39, 420), (203, 360), (358, 330)]",0.75,9.00497512437811,8,0.813953488372093,10,11,21
174,"[(518, 356.0), (452, 276.0), (357, 120)]",1.0,3.0,3,0.0,3,3,6
175,"[(106, 480), (334, 7.0)]",0.5,2.0,2,0.0,2,1,3
176,"[(257, 930), (432, 840), (330, 660), (219, 601.0), (153, 420)]",0.8571428571428571,5.333333333333333,5,0.4074074074074074,6,7,13
177,"[(153, 780), (134, 540), (176, 150), (330, 90), (260, 17.0)]",0.6,3.8,5,0.5,5,3,8
178,"[(380, 330), (160, 210), (293, 25.0)]",0.6666666666666666,3.0,2,0.8,3,2,5
179,"[(439, 240), (24, 206.0)]",1.0,2.0,2,0.0,2,2,4
180,"[(453, 1019.0), (460, 150.0), (501, 61.0), (np.int64(243), 30), (164, 2.0)]",0.4,4.0,5,0.5,4,3,7
181,"[(293, 240), (8, 84.0), (20, 65.0), (321, 30.0), (508, 8.0)]",0.4,4.605263157894736,4,1.0,5,2,7
182,"[(481, 960), (552, 540), (41, 330), (265, 210), (449, 150)]",0.8571428571428571,6.222222222222221,5,0.4375,7,6,13
183,"[(136, 240), (490, 150), (np.int64(493), 46.0), (358, 30), (np.int64(295), 5.0)]",0.4,2.9210526315789473,3,0.0,3,4,7
184,"[(231, 6930), (101, 570), (373, 273.0), (388, 9.0)]",0.75,3.111111111111111,4,0.0,4,3,7
185,"[(365, 244.0), (21, 210), (265, 94.0), (467, 28.0)]",0.5,4.0,4,0.0,4,2,6
186,"[(271, 90), (np.int64(445), 55.0)]",0.5,1.0,2,0.0,1,2,3
187,"[(399, 360), (64, 82.0), (273, 71.0), (465, 41.0), (406, 39.0)]",0.8333333333333334,4.800000000000001,5,0.5,6,5,11
188,"[(26, 3090), (214, 930), (534, 120.0), (46, 70.0)]",0.75,4.0,4,0.0,4,3,7
189,"[(240, 721.0), (533, 690), (482, 120), (np.int64(532), 4.0)]",0.75,3.0,4,0.6,3,4,7
190,"[(400, 501.0), (20, 210), (544, 180), (344, 90)]",1.0,3.3333333333333335,4,0.0,4,4,8
191,"[(146, 810), (np.int64(38), 30.0), (299, 2.0)]",0.3333333333333333,1.8,2,0.0,2,2,4
192,"[(207, 780), (324, 647.0)]",1.0,2.0,3,0.0,2,2,4
193,"[(395, 1350), (411, 930), (np.int64(28), 5.0)]",0.6666666666666666,1.0,2,0.0,2,3,5
194,"[(203, 172.0), (249, 121.0), (507, 116.0), (68, 101.0), (277, 60)]",0.25,7.441860465116279,8,1.0,8,2,10
195,"[(474, 600), (289, 523.0), (234, 287.0), (224, 258.0), (504, 240)]",0.35294117647058826,14.704453441295547,9,0.0,16,7,23
196,"[(425, 570), (67, 180), (289, 120), (np.int64(481), 99.0), (24, 90)]",0.5,4.354838709677419,6,0.14285714285714285,5,7,12
197,"[(305, 1044.0), (416, 270), (2, 243.0), (168, 188.0), (50, 90)]",0.7142857142857143,5.213114754098361,6,0.0,6,6,12
198,"[(200, 642.0), (251, 600), (564, 420), (199, 398.0), (291, 219.0)]",0.7142857142857143,4.426229508196721,6,0.6363636363636364,5,7,12
199,"[(367, 2130.0), (198, 398.0), (200, 205.0), (50, 134.0), (207, 126.0)]",0.75,6.5058823529411764,7,0.0,7,7,14
200,"[(198, 642.0), (273, 210), (199, 205.0), (319, 150), (np.int64(328), 96.0)]",0.6666666666666666,4.51219512195122,5,0.8,5,5,10
201,"[(348, 540), (136, 136.0)]",1.0,2.0,3,0.25,2,2,4
202,"[(125, 784.0), (74, 210), (173, 90), (217, 4.0)]",0.75,4.0,5,0.25,4,3,7
203,"[(287, 492.0), (173, 360), (194, 172.0), (467, 120), (448, 90)]",1.0,6.5,5,0.6666666666666666,7,7,14
204,"[(237, 240), (514, 150), (312, 84.0), (np.int64(442), 44.0), (361, 15.0)]",0.6,3.36,3,0.0,4,4,8
205,"[(3, 2640), (243, 629.0), (325, 450), (173, 120), (551, 30)]",0.7142857142857143,5.852459016393443,7,0.16666666666666666,7,5,12
206,"[(434, 2578.0), (208, 330), (207, 180), (309, 150), (40, 90)]",0.8333333333333334,3.8,4,0.6,5,6,11
207,"[(388, 3300), (98, 1042.0), (192, 780), (549, 330), (206, 180)]",0.6923076923076923,10.85135135135135,10,0.0,11,11,22
208,"[(206, 330), (407, 300), (4, 210), (309, 90), (353, 90)]",0.875,6.857142857142858,6,0.42857142857142855,8,7,15
209,"[(138, 2070), (np.int64(313), 283.0), (410, 144.0), (np.int64(468), 83.0)]",0.5,1.6923076923076923,4,0.0,2,4,6
210,"[(127, 870), (317, 690), (138, 390), (239, 360), (442, 120)]",0.8333333333333334,4.8,6,0.9411764705882353,5,6,11
211,"[(np.int64(93), 2479.0), (np.int64(78), 1811.0), (439, 390), (305, 390), (np.int64(127), 100.0)]",0.2857142857142857,2.911764705882353,4,0.0,3,6,9
212,"[(470, 14250), (409, 6443.0), (46, 1530), (506, 96.0), (333, 60)]",0.8,5.0,5,0.0,5,4,9
213,"[(81, 270), (248, 76.0)]",0.5,2.0,3,1.0,2,1,3
214,"[(188, 930), (np.int64(13), 30), (np.int64(417), 19.0)]",0.3333333333333333,1.0,3,0.25,1,3,4
215,"[(255, 9240), (25, 240), (235, 28.0)]",0.6666666666666666,3.0,2,0.0,3,2,5
216,"[(462, 85800), (np.int64(147), 70.0), (38, 6.0)]",0.3333333333333333,2.0,2,0.5287128712871287,2,2,4
217,"[(100, 720), (369, 450), (555, 120), (207, 120), (np.int64(38), 81.0)]",0.5714285714285714,3.686274509803922,6,0.5,4,7,11
218,"[(271, 423.0), (345, 180), (432, 90), (np.int64(261), 60), (313, 2.0)]",0.6,4.0,4,0.0,4,4,8
219,"[(np.int64(362), 670.0), (176, 601.0), (435, 360), (334, 360), (99, 36.0)]",0.8333333333333334,4.4,5,0.4,5,6,11
220,"[(221, 1873.0), (np.int64(504), 213.0), (340, 90), (np.int64(268), 73.0), (np.int64(168), 50.0)]",0.4,1.8947368421052633,5,0.5,2,5,7
221,"[(220, 1873.0), (27, 604.0), (50, 239.0), (470, 120), (141, 98.0)]",1.0,4.25,3,0.0,5,5,10
222,"[(476, 360), (np.int64(336), 39.0), (122, 25.0), (np.int64(123), 11.0), (40, 2.0)]",0.2,2.892857142857143,5,0.0,3,3,6
223,"[(81, 6390), (307, 1530), (94, 1350), (np.int64(488), 635.0), (36, 240)]",0.8,3.0,4,0.0,4,5,9
224,"[(434, 7740), (540, 1500), (83, 510.0), (np.int64(195), 258.0)]",0.75,2.833333333333333,3,0.0,3,4,7
225,"[(261, 630), (289, 240), (196, 56.0), (107, 41.0), (np.int64(481), 21.0)]",0.6,3.6,4,0.0,4,4,8
226,"[(363, 960), (442, 570), (567, 540), (394, 90), (236, 54.0)]",0.6666666666666666,6.0,5,0.6111111111111112,6,4,10
227,"[(326, 180), (247, 60)]",0.5,0.0,2,0.0,2,1,3
228,"[(151, 3480), (39, 660), (371, 211.0), (92, 200.0)]",1.0,4.0,4,0.0,4,4,8
229,"[(366, 25920)]",1.0,1.0,1,0.7216828478964401,1,1,2
230,"[(287, 630), (np.int64(487), 94.0)]",0.5,1.0,2,0.5,1,2,3
231,"[(385, 11340), (184, 6930), (232, 1838.0), (101, 1230), (109, 150)]",1.0,5.2,5,0.6728971962616822,6,6,12
232,"[(233, 2850), (284, 2100), (231, 1838.0), (537, 540), (79, 210)]",1.0,4.5,5,0.3448275862068966,5,5,10
233,"[(232, 2850), (29, 1260), (144, 360), (54, 180), (283, 7.0)]",0.8,3.75,4,0.12,5,4,9
234,"[(125, 5610), (360, 600), (412, 420), (195, 287.0), (376, 240)]",0.6666666666666666,9.038461538461538,9,0.546875,10,10,20
235,"[(520, 330), (306, 265.0), (np.int64(215), 28.0)]",0.6666666666666666,2.0,3,0.5,2,3,5
236,"[(85, 2880), (75, 60), (np.int64(226), 54.0), (346, 30)]",0.5,1.6153846153846154,4,0.0,3,3,6
237,"[(514, 510), (404, 510), (204, 240), (108, 60), (79, 54.0)]",0.8,3.75,4,0.0,5,4,9
238,"[(248, 570), (391, 270)]",1.0,2.0,4,1.0,2,2,4
239,"[(210, 360), (278, 32.0), (478, 20.0)]",0.6666666666666666,2.25,2,0.5714285714285714,3,2,5
240,"[(93, 2610), (393, 2160), (189, 721.0), (498, 82.0)]",1.0,3.3333333333333335,3,0.6129032258064516,4,4,8
241,"[(272, 180), (np.int64(73), 89.0), (113, 23.0)]",0.3333333333333333,2.0,4,0.0,2,2,4
242,"[(23, 420), (519, 150), (428, 31.0)]",1.0,3.0,2,0.8571428571428571,3,3,6
243,"[(244, 1230), (205, 629.0), (180, 30)]",0.6666666666666666,3.0,3,0.2222222222222222,3,2,5
244,"[(243, 1230), (171, 1120.0)]",1.0,2.0,3,0.7,2,2,4
245,"[(300, 120), (274, 95.0), (411, 74.0), (413, 25.0)]",1.0,3.0,3,1.0,4,4,8
246,"[(173, 1500), (67, 570), (303, 270), (442, 180), (53, 150)]",0.8571428571428571,5.333333333333333,7,0.3888888888888889,6,7,13
247,"[(326, 300), (356, 117.0), (65, 69.0), (np.int64(227), 60)]",0.75,2.6666666666666665,3,0.75,3,4,7
248,"[(238, 570), (502, 237.0), (289, 196.0), (269, 113.0), (np.int64(213), 76.0)]",0.5714285714285714,3.3333333333333335,5,0.0,4,7,11
249,"[(np.int64(194), 121.0), (82, 30)]",0.0,1.0,2,0.0,1,1,2
250,"[(511, 420), (np.int64(469), 148.0), (2, 121.0), (np.int64(294), 90), (np.int64(168), 73.0)]",0.2857142857142857,2.514705882352941,6,0.0,3,6,9
251,"[(530, 3810), (198, 600), (134, 390), (np.int64(30), 90), (286, 3.0)]",0.6,3.68,7,0.20689655172413793,4,4,8
252,"[(444, 246.0), (342, 240), (34, 30)]",0.3333333333333333,3.0,5,0.0,3,1,4
253,"[(76, 210), (np.int64(168), 65.0), (np.int64(500), 30.0)]",0.3333333333333333,1.0,5,0.0,1,3,4
254,"[(454, 1230), (np.int64(116), 3.0)]",0.5,1.0,2,0.5,1,2,3
255,"[(215, 9240), (316, 1860), (475, 385.0), (522, 239.0), (22, 227.0)]",0.6666666666666666,5.0,5,0.05263157894736842,5,5,10
256,"[(405, 90), (np.int64(167), 53.0), (np.int64(266), 30)]",0.3333333333333333,0.6,2,0.0,1,3,4
257,"[(466, 1393.0), (176, 930)]",1.0,2.0,3,0.0,2,2,4
258,"[(290, 870), (438, 300), (273, 210), (436, 90), (379, 58.0)]",0.8,3.75,3,0.0,5,4,9
259,"[(451, 3120), (140, 296.0), (318, 248.0), (159, 124.0)]",0.75,3.111111111111111,4,0.30434782608695654,4,3,7
260,"[(35, 1121.0), (68, 540), (np.int64(1), 104.0), (np.int64(177), 17.0)]",0.5,1.6923076923076923,4,0.4,2,4,6
261,"[(66, 4306.0), (225, 630), (285, 570), (534, 450), (22, 240)]",0.6666666666666666,9.0,9,0.0,9,6,15
262,"[(501, 900), (399, 405.0), (3, 210), (79, 150), (173, 60)]",0.6666666666666666,5.7073170731707314,6,0.5789473684210527,6,4,10
263,"[(376, 220.0), (167, 145.0), (1, 90)]",1.0,3.0,3,0.0,3,3,6
264,"[(532, 120), (29, 60), (np.int64(325), 60), (np.int64(385), 60)]",0.5,1.8461538461538463,4,0.5,2,4,6
265,"[(552, 270), (182, 210), (np.int64(185), 94.0), (np.int64(479), 63.0)]",0.5,1.3846153846153846,4,0.3333333333333333,2,4,6
266,"[(405, 1260), (507, 690), (77, 421.0), (281, 120), (np.int64(43), 67.0)]",0.5555555555555556,7.441860465116279,8,0.9285714285714286,8,6,14
267,"[(354, 180), (np.int64(382), 53.0)]",0.5,1.0,2,0.0,1,2,3
268,"[(497, 1050), (np.int64(21), 100.0), (374, 86.0), (220, 73.0), (409, 27.0)]",0.2,4.0,4,0.875,4,2,6
269,"[(402, 330), (np.int64(143), 328.0), (248, 113.0), (np.int64(195), 71.0), (289, 22.0)]",0.4,1.973684210526316,5,0.0,3,4,7
270,"[(339, 840), (np.int64(477), 209.0), (163, 180), (np.int64(168), 129.0), (np.int64(84), 90.0)]",0.3333333333333333,2.942307692307692,5,0.0,3,5,8
271,"[(2, 6390), (218, 423.0), (36, 420), (np.int64(167), 144.0), (186, 90)]",0.5,3.741935483870968,9,0.5925925925925926,4,8,12
272,"[(369, 810), (388, 780), (69, 750), (241, 180), (307, 60)]",0.5714285714285714,5.529411764705882,7,0.0,6,5,11
273,"[(422, 1590), (57, 240), (64, 220.0), (200, 210), (258, 210)]",1.0,6.666666666666666,6,0.0,7,7,14
274,"[(172, 120), (245, 95.0), (413, 91.0), (398, 90)]",1.0,3.3333333333333335,3,0.0,4,4,8
275,"[(496, 776.0), (458, 90)]",0.5,2.0,3,0.0,2,1,3
276,"[(168, 375.0), (377, 120), (np.int64(321), 30), (297, 18.0), (np.int64(505), 10.0)]",0.2,2.5714285714285716,5,0.0,3,3,6
277,"[(165, 1330.0), (512, 840), (194, 60)]",1.0,3.0,3,0.0,3,3,6
278,"[(80, 3570), (47, 330), (478, 222.0), (379, 60), (np.int64(239), 32.0)]",0.8,3.75,3,0.0,4,5,9
279,"[(68, 136.0), (np.int64(450), 110.0), (323, 90), (np.int64(403), 75.0)]",0.5,1.5384615384615383,4,0.0,2,4,6
280,"[(358, 125.0), (148, 70.0), (323, 60), (341, 9.0)]",0.25,4.0,6,0.0,4,1,5
281,"[(479, 627.0), (405, 240), (266, 120), (387, 30)]",0.75,3.111111111111111,3,0.5,4,3,7
282,"[(462, 930), (434, 598.0), (299, 360), (448, 300), (71, 180)]",1.0,4.0,4,0.0,5,5,10
283,"[(385, 990), (np.int64(233), 7.0)]",0.5,1.0,4,0.6666666666666666,1,2,3
284,"[(232, 2100), (555, 630), (22, 540), (557, 300), (519, 243.0)]",0.8333333333333334,10.60180995475113,8,0.5714285714285714,11,11,22
285,"[(261, 570), (147, 510), (150, 240), (169, 180), (np.int64(234), 68.0)]",0.6666666666666666,4.451219512195122,6,0.16666666666666666,5,5,10
286,"[(81, 210), (510, 60), (449, 16.0), (np.int64(251), 3.0)]",0.5,3.0,4,0.75,3,3,6
287,"[(230, 630), (203, 492.0), (161, 137.0), (567, 90), (np.int64(194), 55.0)]",0.8,3.75,4,0.75,4,5,9
288,"[(88, 3480)]",1.0,1.0,2,0.125,1,1,2
289,"[(127, 900.0), (362, 630), (195, 523.0), (466, 399.0), (np.int64(26), 253.0)]",0.625,11.314285714285713,10,0.0,12,14,26
290,"[(438, 2880), (258, 870), (315, 121.0)]",1.0,2.0,2,0.0,3,3,6
291,"[(528, 300), (198, 219.0), (384, 59.0), (199, 2.0)]",0.75,3.5555555555555554,4,0.6666666666666666,4,3,7
292,"[(482, 1017.0), (478, 673.0), (114, 421.0), (3, 90), (np.int64(173), 30)]",0.5714285714285714,4.509803921568627,5,0.0,5,6,11
293,"[(170, 10560), (4, 269.0), (181, 240), (np.int64(178), 25.0)]",0.75,3.0,4,0.4878048780487805,3,4,7
294,"[(511, 540), (460, 270), (250, 90), (np.int64(328), 23.0)]",0.5,2.5384615384615383,4,0.875,3,3,6
295,"[(71, 810), (np.int64(493), 568.0), (462, 114.0), (426, 60), (183, 5.0)]",0.4,3.473684210526316,3,0.9230769230769231,4,3,7
296,"[(366, 1110), (382, 1080), (152, 840), (np.int64(344), 66.0), (451, 52.0)]",0.6666666666666666,5.0,5,0.08333333333333333,5,5,10
297,"[(527, 90), (np.int64(11), 51.0), (np.int64(276), 18.0)]",0.3333333333333333,1.0,4,0.0,1,3,4
298,"[(512, 5160), (155, 750)]",1.0,2.0,2,0.0,2,2,4
299,"[(462, 8400), (282, 360), (np.int64(197), 83.0), (np.int64(38), 38.0), (np.int64(191), 2.0)]",0.4,1.5263157894736843,4,0.0,2,5,7
300,"[(396, 849.0), (245, 120), (6, 48.0)]",0.6666666666666666,2.25,4,0.375,3,2,5
301,"[(351, 9274.0), (74, 1394.0), (np.int64(367), 60), (np.int64(381), 60)]",0.5,1.3846153846153846,4,0.38461538461538464,2,4,6
302,"[(414, 300), (84, 146.0), (506, 120), (np.int64(406), 90), (np.int64(10), 33.0)]",0.5,2.8181818181818183,5,0.5,3,6,9
303,"[(442, 390), (246, 270), (348, 144.0), (441, 60), (158, 11.0)]",0.8,2.5,5,0.5714285714285714,5,4,9
304,"[(478, 30), (126, 23.0), (451, 20.0)]",0.0,3.0,3,0.0,3,0,3
305,"[(517, 1786.0), (197, 1044.0), (165, 720), (2, 398.0), (211, 390)]",1.0,5.6,5,0.0,6,6,12
306,"[(355, 1290), (235, 265.0), (np.int64(25), 30)]",0.6666666666666666,2.0,3,0.4375,2,3,5
307,"[(28, 1590), (223, 1530), (346, 780), (497, 510), (129, 360)]",0.9,8.555555555555555,7,0.11764705882352941,9,10,19
308,"[(336, 180), (162, 157.0)]",1.0,2.0,2,0.5,2,2,4
309,"[(407, 720), (206, 150), (208, 90), (514, 78.0)]",0.75,1.7777777777777777,3,0.0,4,3,7
310,"[(368, 5867.0), (515, 2670), (511, 1170), (116, 870), (171, 87.0)]",0.8333333333333334,5.04,5,0.0,6,5,11
311,"[(5, 330), (np.int64(42), 206.0)]",0.5,1.0,2,1.0,1,2,3
312,"[(204, 84.0), (543, 30)]",0.5,2.0,2,0.0,2,1,3
313,"[(339, 1200), (209, 283.0), (163, 240), (410, 175.0), (np.int64(325), 136.0)]",0.42857142857142855,4.761904761904762,5,0.5555555555555556,5,5,10
314,"[(353, 120), (np.int64(15), 2.0)]",0.5,1.0,2,0.0,1,2,3
315,"[(np.int64(342), 2293.0), (493, 990), (29, 176.0), (532, 150), (290, 121.0)]",0.7142857142857143,6.0,6,0.0,6,6,12
316,"[(255, 1860), (474, 210), (437, 127.0), (322, 90), (150, 28.0)]",0.6,5.0,5,0.25,5,3,8
317,"[(63, 1646.0), (80, 1241.0), (210, 690), (480, 570), (73, 510)]",1.0,6.333333333333333,5,0.0,7,7,14
318,"[(415, 300), (259, 248.0), (109, 240), (112, 159.0), (140, 71.0)]",0.6666666666666666,5.7073170731707314,7,0.75,6,4,10
319,"[(33, 2220.0), (200, 150), (32, 2.0)]",0.6666666666666666,2.25,3,0.0,3,2,5
320,"[(419, 4650), (6, 450), (np.int64(398), 125.0), (234, 90)]",0.75,2.3333333333333335,4,0.0,3,4,7
321,"[(377, 690), (102, 486.0), (77, 480), (276, 30), (np.int64(181), 30.0)]",0.4,2.736842105263158,4,0.6363636363636364,4,3,7
322,"[(11, 810), (86, 180), (316, 90), (208, 31.0), (529, 7.0)]",0.6666666666666666,5.0,6,0.3333333333333333,5,5,10
323,"[(374, 300), (468, 300), (83, 163.0), (169, 120), (162, 120)]",0.8,8.565517241379311,9,0.0,9,9,18
324,"[(192, 647.0), (128, 180), (480, 180), (np.int64(460), 61.0), (np.int64(527), 21.0)]",0.6,3.0,4,0.0,3,5,8
325,"[(3, 510), (205, 450), (551, 180), (481, 180), (313, 136.0)]",0.5714285714285714,6.1764705882352935,6,0.8571428571428571,7,4,11
326,"[(247, 300), (227, 180), (167, 72.0)]",0.6666666666666666,2.25,2,0.75,3,2,5
327,"[(404, 680.0), (167, 570), (514, 41.0)]",0.6666666666666666,2.25,2,0.0,3,2,5
328,"[(131, 406.0), (30, 100.0), (200, 96.0), (31, 90), (294, 23.0)]",0.42857142857142855,7.0,7,0.0,7,3,10
329,"[(550, 450), (399, 15.0)]",0.5,2.0,3,0.4,2,1,3
330,"[(176, 660), (389, 450), (np.int64(177), 90), (88, 79.0), (440, 6.0)]",0.6,3.36,5,0.0,4,4,8
331,"[(131, 390), (567, 120)]",1.0,2.0,3,0.25,2,2,4
332,"[(476, 1458.0), (45, 300), (np.int64(72), 124.0), (np.int64(78), 60.0), (np.int64(55), 43.0)]",0.3333333333333333,3.0,7,0.4117647058823529,3,5,8
333,"[(169, 338.0), (212, 60), (49, 37.0)]",1.0,3.0,4,0.6666666666666666,3,3,6
334,"[(435, 720), (219, 360), (344, 169.0), (378, 61.0), (38, 45.0)]",0.4,7.448275862068965,12,0.0,8,6,14
335,"[(15, 630), (np.int64(444), 344.0)]",0.5,1.0,2,0.8571428571428571,1,2,3
336,"[(447, 1193.0), (367, 900), (495, 227.0), (308, 180), (558, 90)]",0.75,7.952941176470588,5,0.0,8,6,14
337,"[(466, 150), (154, 120)]",1.0,2.0,2,0.0,2,2,4
338,"[(66, 540), (83, 120), (361, 34.0)]",1.0,2.0,3,0.0,3,3,6
339,"[(114, 3480), (162, 1320), (313, 1200), (270, 840), (np.int64(349), 39.0)]",0.8,4.0,5,0.0,4,5,9
340,"[(395, 4055.0), (34, 1740), (159, 151.0), (220, 90)]",1.0,4.0,5,0.7857142857142857,4,4,8
341,"[(np.int64(69), 587.0), (401, 60), (np.int64(280), 9.0)]",0.3333333333333333,1.0,2,0.0,1,3,4
342,"[(315, 2293.0), (252, 240)]",0.5,2.0,2,0.0,2,1,3
343,"[(np.int64(425), 133.0), (509, 60)]",0.5,1.0,2,0.0,1,2,3
344,"[(20, 510), (1, 241.0), (334, 169.0), (104, 150), (207, 104.0)]",0.42857142857142855,10.252717391304348,9,0.0,11,9,20
345,"[(218, 180), (99, 120)]",1.0,2.0,3,1.0,2,2,4
346,"[(307, 780), (85, 300), (np.int64(460), 170.0), (540, 120), (463, 120)]",0.6363636363636364,7.671232876712329,11,0.6666666666666666,8,10,18
347,"[(111, 1290), (521, 38.0)]",1.0,2.0,2,0.0,2,2,4
348,"[(158, 754.0), (201, 540), (561, 270), (303, 144.0), (442, 95.0)]",0.7142857142857143,4.8196721311475414,6,0.45454545454545453,6,6,12
349,"[(427, 1019.0), (111, 716.0), (108, 210), (8, 179.0), (339, 39.0)]",0.5714285714285714,6.0,6,0.0,6,5,11
350,"[(481, 240), (40, 33.0)]",0.5,2.0,4,0.0,2,1,3
351,"[(301, 9274.0), (74, 509.0), (172, 480)]",1.0,2.0,3,0.85,3,3,6
352,"[(428, 5070), (490, 543.0), (np.int64(424), 140.0), (44, 71.0), (np.int64(527), 36.0)]",0.4,2.8421052631578947,4,0.0,3,4,7
353,"[(133, 480), (314, 120), (208, 90), (142, 60), (516, 60)]",0.8571428571428571,7.0,6,0.75,7,6,13
354,"[(90, 330), (267, 180), (47, 153.0)]",1.0,3.0,2,0.0,3,3,6
355,"[(306, 1290), (9, 565.0), (369, 16.0)]",1.0,3.0,3,0.4117647058823529,3,3,6
356,"[(508, 390), (247, 117.0)]",1.0,2.0,2,0.3333333333333333,2,2,4
357,"[(406, 429.0), (53, 180), (174, 120), (np.int64(64), 2.0)]",0.75,2.6666666666666665,4,0.375,3,4,7
358,"[(369, 3030), (69, 600), (456, 540), (401, 360), (173, 330)]",0.7,7.2558139534883725,8,0.0,8,9,17
359,"[(432, 625.0), (473, 240), (np.int64(2), 2.0)]",0.6666666666666666,2.0,4,0.8888888888888888,2,3,5
360,"[(476, 3540), (527, 1980), (234, 600), (381, 510), (69, 480)]",0.75,6.670588235294117,6,0.0,7,7,14
361,"[(89, 3510), (338, 34.0), (np.int64(204), 15.0)]",0.6666666666666666,2.0,3,0.15,2,3,5
362,"[(219, 670.0), (289, 630), (26, 334.0), (0, 55.0)]",0.75,3.5555555555555554,5,0.0,4,3,7
363,"[(226, 960), (np.int64(38), 55.0), (292, 18.0)]",0.3333333333333333,2.0,5,0.9375,2,2,4
364,"[(375, 300), (205, 15.0)]",1.0,2.0,2,0.0,2,2,4
365,"[(418, 2910), (185, 244.0), (96, 210)]",1.0,3.0,3,0.0,3,3,6
366,"[(229, 25920), (72, 13440), (296, 1110), (529, 90), (463, 43.0)]",0.8,5.0,4,0.5517241379310345,5,4,9
367,"[(199, 2130.0), (336, 900), (301, 60), (np.int64(261), 30.0)]",0.5,3.0,4,0.0,3,3,6
368,"[(310, 5867.0), (33, 690), (119, 371.0), (171, 90.0)]",0.75,3.111111111111111,5,0.5,4,3,7
369,"[(358, 3030), (127, 1650), (272, 810), (217, 450), (317, 360)]",0.75,9.502487562189055,10,0.17857142857142858,10,11,21
370,"[(10, 150), (136, 60)]",1.0,2.0,3,0.0,2,2,4
371,"[(13, 1440), (228, 211.0), (491, 168.0)]",1.0,3.0,3,0.7058823529411765,3,3,6
372,"[(487, 1470), (490, 300), (np.int64(542), 30), (np.int64(117), 17.0)]",0.5,2.0,3,0.8181818181818182,2,4,6
373,"[(184, 273.0), (554, 120), (421, 2.0)]",0.6666666666666666,3.0,3,0.0,3,2,5
374,"[(162, 540), (323, 300), (np.int64(268), 86.0), (np.int64(470), 30)]",0.5,1.3846153846153846,4,0.5714285714285714,2,4,6
375,"[(9, 3240), (10, 1800), (112, 960), (453, 300), (364, 300)]",0.8333333333333334,4.6000000000000005,4,0.21428571428571427,5,6,11
376,"[(125, 690), (43, 270), (234, 240), (124, 240), (263, 220.0)]",1.0,4.0,6,0.4,6,6,12
377,"[(321, 690), (77, 180), (276, 120), (431, 20.0)]",0.75,2.666666666666667,3,1.0,4,3,7
378,"[(522, 930), (48, 510), (450, 210), (561, 180), (334, 61.0)]",1.0,5.6,3,0.0,6,6,12
379,"[(278, 60), (np.int64(258), 58.0)]",0.5,1.0,2,0.0,1,2,3
380,"[(178, 330), (12, 150), (105, 120), (503, 90), (79, 60)]",0.6666666666666666,3.7804878048780486,5,0.8333333333333334,5,5,10
381,"[(360, 510), (431, 480), (np.int64(481), 303.0), (496, 270), (67, 120)]",0.5714285714285714,4.1764705882352935,6,0.0,6,5,11
382,"[(296, 1080), (42, 240), (255, 90.0), (np.int64(38), 57.0), (267, 53.0)]",0.4,4.0,4,0.6875,4,3,7
383,"[(460, 2010), (284, 109.0), (np.int64(3), 30)]",0.6666666666666666,2.0,4,0.7777777777777778,2,3,5
384,"[(79, 270), (291, 59.0), (np.int64(200), 48.0)]",0.6666666666666666,2.0,3,0.0,2,3,5
385,"[(231, 11340), (0, 3960), (28, 2820), (41, 1200), (283, 990)]",0.6666666666666666,8.90909090909091,7,0.30701754385964913,9,6,15
386,"[(103, 2078.0), (487, 690), (284, 90)]",1.0,2.0,3,0.0,3,3,6
387,"[(66, 570), (494, 150), (np.int64(516), 53.0), (np.int64(281), 30), (np.int64(509), 27.0)]",0.4,2.0,3,0.0,2,5,7
388,"[(207, 3300), (272, 780), (np.int64(360), 30), (np.int64(184), 9.0)]",0.5,2.0,4,0.0,2,4,6
389,"[(330, 450), (523, 269.0), (120, 60.0)]",0.6666666666666666,3.0,4,0.0,3,2,5
390,"[(84, 150), (np.int64(195), 72.0)]",0.5,1.0,4,0.0,1,2,3
391,"[(28, 1440), (238, 270), (71, 261.0), (np.int64(194), 50.0), (np.int64(284), 35.0)]",0.42857142857142855,4.2857142857142865,8,1.0,5,5,10
392,"[(np.int64(403), 90), (np.int64(75), 54.0)]",0.0,0.0,3,0.0,0,2,2
393,"[(240, 2160), (93, 600), (523, 60)]",1.0,2.0,3,0.5294117647058824,3,3,6
394,"[(446, 265.0), (120, 120), (226, 90), (np.int64(546), 30)]",0.75,2.6666666666666665,3,0.5,3,4,7
395,"[(340, 4055.0), (411, 1950), (193, 1350), (np.int64(405), 210.0), (446, 150)]",0.8,3.5,3,0.0,4,5,9
396,"[(300, 849.0), (284, 180), (10, 120), (6, 54.0)]",1.0,3.6666666666666665,5,0.0,4,4,8
397,"[(560, 540)]",1.0,1.0,1,0.5714285714285714,1,1,2
398,"[(320, 125.0), (274, 90), (np.int64(80), 64.0), (155, 48.0)]",0.25,3.0,4,0.0,3,2,5
399,"[(459, 1590), (108, 999.0), (262, 405.0), (503, 380.0), (187, 360)]",0.75,6.5058823529411764,6,0.0,7,7,14
400,"[(441, 1956.0), (131, 809.0), (138, 510), (190, 501.0)]",1.0,3.3333333333333335,4,0.0,4,4,8
401,"[(358, 360), (151, 180), (341, 60)]",1.0,3.0,5,0.5,3,3,6
402,"[(269, 330), (187, 15.0)]",1.0,2.0,4,0.0,2,2,4
403,"[(474, 347.0), (392, 90), (68, 79.0), (279, 75.0)]",0.5,2.769230769230769,3,0.0,4,2,6
404,"[(327, 680.0), (237, 510), (514, 210)]",1.0,1.5,2,0.6666666666666666,3,3,6
405,"[(266, 1260), (281, 240), (395, 210.0), (256, 90)]",0.75,2.666666666666667,2,0.9666666666666667,4,3,7
406,"[(465, 898.0), (357, 429.0), (64, 187.0), (302, 90), (187, 39.0)]",0.6666666666666666,4.024390243902439,5,0.0,5,5,10
407,"[(309, 720), (np.int64(171), 561.0), (208, 300), (206, 30)]",0.5,1.1538461538461537,4,0.0,3,3,6
408,"[(36, 159.0), (np.int64(30), 90), (564, 30), (42, 15.0)]",0.0,3.0,6,0.0,3,1,4
409,"[(212, 6443.0), (105, 4170), (134, 1880.0), (78, 210), (73, 101.0)]",0.8571428571428571,5.666666666666666,6,0.0,6,7,13
410,"[(545, 210), (313, 175.0), (209, 144.0)]",1.0,2.5,3,0.6666666666666666,3,3,6
411,"[(395, 1950), (193, 930), (245, 74.0), (np.int64(413), 63.0)]",0.75,2.0,2,0.0,3,4,7
412,"[(9, 965.0), (234, 420), (122, 390), (556, 210), (np.int64(72), 5.0)]",0.8,4.0,4,0.0,4,5,9
413,"[(274, 91.0), (411, 63.0), (np.int64(261), 30), (245, 25.0)]",0.5,1.6153846153846154,3,0.0,3,3,6
414,"[(74, 1410), (477, 1230), (302, 300), (203, 84.0), (132, 60)]",1.0,3.25,4,0.0,5,5,10
415,"[(318, 300), (138, 283.0), (511, 232.0), (np.int64(97), 17.0)]",0.5,3.0,5,0.0,3,3,6
416,"[(197, 270), (57, 41.0)]",0.5,2.0,3,1.0,2,1,3
417,"[(475, 510), (np.int64(234), 49.0), (214, 19.0), (np.int64(285), 6.0)]",0.25,1.6666666666666667,5,0.5,2,3,5
418,"[(365, 2910), (430, 270)]",1.0,2.0,1,0.3125,2,2,4
419,"[(320, 4650), (420, 1110), (6, 369.0), (80, 180)]",1.0,3.3333333333333335,3,0.09090909090909091,4,4,8
420,"[(419, 1110), (np.int64(52), 41.0), (123, 30), (np.int64(486), 30)]",0.25,2.0,4,0.9,2,3,5
421,"[(14, 3051.0), (49, 30), (np.int64(373), 2.0)]",0.3333333333333333,2.0,4,0.0,2,2,4
422,"[(109, 2610), (535, 2100), (273, 1590), (161, 210), (51, 130.0)]",0.625,5.671232876712329,6,0.0,6,7,13
423,"[(469, 480), (133, 270), (np.int64(199), 30), (452, 17.0)]",0.5,3.0,5,0.7142857142857143,3,3,6
424,"[(352, 140.0), (271, 53.0), (207, 30)]",0.0,3.0,3,0.0,3,0,3
425,"[(196, 570), (246, 148.0), (343, 133.0)]",0.3333333333333333,3.0,4,1.0,3,1,4
426,"[(506, 750), (71, 180), (479, 90), (np.int64(295), 60), (100, 2.0)]",0.6,3.36,5,0.0,4,4,8
427,"[(349, 1019.0), (79, 570)]",1.0,2.0,2,0.0,2,2,4
428,"[(352, 5070), (147, 60), (242, 31.0)]",0.6666666666666666,3.0,4,0.0,3,2,5
429,"[(13, 2040), (199, 83.0), (497, 41.0), (np.int64(334), 19.0), (np.int64(110), 4.0)]",0.4,3.0,6,0.0,3,4,7
430,"[(418, 270), (115, 81.0)]",1.0,2.0,2,0.0,2,2,4
431,"[(496, 660), (381, 480), (67, 300), (np.int64(377), 20.0)]",0.75,1.0,4,0.0,3,4,7
432,"[(176, 840), (359, 625.0), (np.int64(484), 218.0), (218, 90), (134, 30)]",0.6,4.0,3,0.2727272727272727,4,4,8
433,"[(37, 270), (45, 240), (np.int64(323), 30), (4, 20.0)]",0.5,3.0,5,0.8,3,3,6
434,"[(136, 52920), (224, 7740), (115, 2880), (206, 2578.0), (76, 630)]",0.8888888888888888,8.296875,7,0.031161473087818695,9,8,17
435,"[(29, 5312.0), (334, 720), (541, 660), (219, 360)]",1.0,3.3333333333333335,3,0.52,4,4,8
436,"[(455, 9874.0), (438, 120), (258, 90)]",1.0,2.0,2,0.25,3,3,6
437,"[(10, 630), (np.int64(316), 127.0), (np.int64(226), 30)]",0.3333333333333333,1.0,3,0.3333333333333333,1,3,4
438,"[(290, 2880), (258, 300), (436, 120), (195, 115.0)]",1.0,2.666666666666667,4,0.75,4,4,8
439,"[(211, 390), (179, 240), (138, 50.0)]",0.6666666666666666,3.0,4,0.0,3,2,5
440,"[(547, 1320), (140, 1170), (88, 372.0), (99, 210), (np.int64(330), 6.0)]",0.8,3.75,4,0.0,4,5,9
441,"[(400, 1956.0), (61, 930), (10, 150), (131, 92.0), (442, 90)]",1.0,5.2,5,0.0,6,6,12
442,"[(226, 570), (303, 390), (246, 180), (210, 120), (348, 95.0)]",0.875,6.36734693877551,6,0.0,8,7,15
443,"[(477, 1333.0), (np.int64(505), 30), (np.int64(475), 3.0)]",0.3333333333333333,0.8,4,0.0,1,3,4
444,"[(335, 344.0), (np.int64(252), 246.0), (6, 180)]",0.3333333333333333,2.0,3,0.0,2,2,4
445,"[(494, 158.0), (56, 90), (186, 55.0)]",0.6666666666666666,3.0,3,0.0,3,2,5
446,"[(394, 265.0), (14, 210), (395, 150)]",1.0,3.0,3,0.8333333333333334,3,3,6
447,"[(336, 1193.0), (527, 510), (360, 300)]",1.0,2.0,3,0.2222222222222222,3,3,6
448,"[(130, 2326.0), (71, 1012.0), (55, 480), (518, 360), (282, 300)]",0.9090909090909091,9.25,10,0.2222222222222222,10,11,21
449,"[(182, 150), (409, 94.0), (104, 90), (np.int64(286), 16.0)]",0.75,3.0,5,0.0,3,4,7
450,"[(378, 210), (279, 110.0), (68, 67.0)]",0.3333333333333333,2.4000000000000004,2,0.0,3,1,4
451,"[(259, 3120), (296, 52.0), (np.int64(304), 20.0)]",0.6666666666666666,2.0,3,0.13333333333333333,2,3,5
452,"[(174, 276.0), (102, 120), (np.int64(423), 17.0)]",0.6666666666666666,2.0,3,1.0,2,3,5
453,"[(180, 1019.0), (375, 300)]",1.0,2.0,2,0.8333333333333334,2,2,4
454,"[(254, 1230), (101, 319.0)]",0.5,2.0,3,0.0,2,1,3
455,"[(436, 9874.0), (490, 180), (17, 65.0)]",0.6666666666666666,3.0,4,0.0,3,2,5
456,"[(111, 1230), (136, 1110), (358, 540), (475, 520.0), (207, 120)]",1.0,4.5,5,0.68,5,5,10
457,"[(117, 420), (np.int64(38), 54.0)]",0.5,1.0,2,0.0,1,2,3
458,"[(275, 90), (np.int64(101), 41.0)]",0.5,1.0,3,0.0,1,2,3
459,"[(399, 1590), (137, 117.0), (np.int64(530), 24.0)]",0.3333333333333333,1.6,3,0.0,2,2,4
460,"[(383, 2010), (294, 270), (346, 170.0), (180, 150.0), (324, 61.0)]",0.6,5.0,6,0.25,5,3,8
461,"[(22, 210)]",1.0,1.0,1,0.0,1,1,2
462,"[(216, 85800), (299, 8400), (282, 930), (479, 193.0), (295, 114.0)]",0.8,4.375,3,0.50177304964539,5,4,9
463,"[(346, 120), (np.int64(366), 43.0)]",0.5,1.0,3,0.0,1,2,3
464,"[(30, 3960), (37, 171.0)]",1.0,2.0,3,0.0,2,2,4
465,"[(485, 2910), (406, 898.0), (np.int64(187), 41.0)]",0.6666666666666666,1.5,3,0.3235294117647059,2,3,5
466,"[(257, 1393.0), (289, 399.0), (337, 150)]",1.0,3.0,4,0.0,3,3,6
467,"[(17, 126.0), (203, 120), (540, 120), (np.int64(185), 28.0)]",0.75,3.0,5,0.0,3,4,7
468,"[(90, 720), (323, 300), (209, 83.0)]",0.6666666666666666,3.0,4,0.0,3,2,5
469,"[(423, 480), (305, 178.0), (250, 148.0)]",0.6666666666666666,3.0,4,0.0,3,2,5
470,"[(212, 14250), (221, 120), (374, 30)]",0.6666666666666666,3.0,3,0.0,3,2,5
471,"[(510, 1620), (63, 239.0), (np.int64(41), 110.0), (11, 68.0), (np.int64(168), 53.0)]",0.2857142857142857,2.6029411764705883,5,0.0,3,6,9
472,"[(553, 90), (142, 17.0)]",0.5,2.0,2,0.0,2,1,3
473,"[(359, 240)]",1.0,1.0,1,0.0,1,1,2
474,"[(195, 600), (526, 360), (403, 347.0), (316, 210), (68, 2.0)]",0.8,4.6875,6,0.0,5,4,9
475,"[(456, 520.0), (417, 510), (255, 385.0), (np.int64(157), 73.0), (234, 63.0)]",0.375,6.730769230769231,6,0.0,7,4,11
476,"[(360, 3540), (332, 1458.0), (222, 360), (143, 13.0)]",0.75,4.0,3,0.0,4,3,7
477,"[(132, 6360), (443, 1333.0), (414, 1230), (74, 480), (270, 209.0)]",0.5714285714285714,3.6764705882352944,5,0.0,5,6,11
478,"[(292, 673.0), (434, 270), (278, 222.0), (np.int64(304), 30), (239, 20.0)]",0.5714285714285714,3.607843137254902,6,0.0,4,7,11
479,"[(281, 627.0), (np.int64(462), 193.0), (426, 90), (265, 63.0)]",0.5,3.0,3,0.25,3,3,6
480,"[(317, 570), (519, 180), (324, 180), (536, 120), (np.int64(139), 2.0)]",0.8,4.0,4,0.0,4,5,9
481,"[(182, 960), (119, 720), (381, 303.0), (350, 240), (325, 180)]",0.5555555555555556,7.534883720930233,6,0.0,8,6,14
482,"[(292, 1017.0), (118, 861.0), (136, 475.0), (189, 120), (np.int64(114), 27.0)]",0.6,3.68,5,0.2857142857142857,4,4,8
483,"[(70, 180), (np.int64(328), 3.0)]",0.5,1.0,2,0.0,1,2,3
484,"[(432, 218.0), (498, 60)]",0.5,2.0,2,0.0,2,1,3
485,"[(465, 2910), (494, 261.0), (17, 210), (np.int64(38), 79.0)]",0.75,3.0,4,0.09090909090909091,3,4,7
486,"[(507, 2640), (422, 124.0), (60, 60), (420, 30)]",0.75,4.0,4,0.5,4,3,7
487,"[(372, 1470), (386, 690), (230, 94.0), (39, 60), (284, 60)]",0.6666666666666666,4.829268292682928,6,0.47058823529411764,6,4,10
488,"[(223, 635.0), (103, 420)]",0.5,2.0,2,0.0,2,1,3
489,"[(139, 660), (153, 299.0)]",1.0,2.0,2,0.0,2,2,4
490,"[(352, 543.0), (372, 300), (455, 180), (183, 150), (448, 60)]",0.8333333333333334,6.0,7,0.7777777777777778,6,5,11
491,"[(523, 240), (371, 168.0), (10, 120), (np.int64(9), 2.0)]",0.75,2.6666666666666665,3,0.0,3,4,7
492,"[(np.int64(113), 60), (np.int64(475), 1.0)]",0.0,0.0,3,0.0,0,2,2
493,"[(315, 990), (295, 568.0), (512, 270), (132, 260.0), (183, 46.0)]",0.6,4.9,5,0.0,5,3,8
494,"[(485, 261.0), (445, 158.0), (387, 150)]",1.0,3.0,3,0.0,3,3,6
495,"[(336, 227.0), (164, 210), (534, 67.0)]",0.6666666666666666,3.0,4,0.75,3,2,5
496,"[(np.int64(275), 776.0), (431, 660), (381, 270), (67, 120), (np.int64(196), 30)]",0.6,1.2000000000000002,4,0.4444444444444444,3,5,8
497,"[(268, 1050), (307, 510), (289, 189.0), (np.int64(429), 41.0)]",0.5,3.0,7,0.0,3,3,6
498,"[(240, 82.0), (484, 60)]",1.0,2.0,2,0.0,2,2,4
499,"[(24, 173.0), (17, 60)]",1.0,2.0,2,0.0,2,2,4
500,"[(151, 103.0), (253, 30.0), (np.int64(7), 30)]",0.3333333333333333,2.0,2,0.0,2,2,4
501,"[(262, 900), (np.int64(180), 61.0)]",0.5,1.0,3,0.4444444444444444,1,2,3
502,"[(563, 780), (248, 237.0)]",1.0,2.0,4,1.0,2,2,4
503,"[(44, 480), (399, 380.0), (157, 252.0), (380, 90), (105, 90)]",0.625,3.904109589041096,5,0.0,5,8,13
504,"[(195, 240), (220, 213.0), (146, 150), (168, 120.0), (75, 76.0)]",0.42857142857142855,4.857142857142858,7,0.0,6,4,10
505,"[(99, 522.0), (59, 71.0), (443, 30), (276, 10.0)]",0.25,4.0,6,0.0,4,1,5
506,"[(426, 750), (302, 120), (np.int64(212), 96.0), (np.int64(71), 30)]",0.5,1.6923076923076923,4,0.0,2,4,6
507,"[(486, 2640), (266, 690), (np.int64(194), 116.0)]",0.6666666666666666,2.0,3,0.5,2,3,5
508,"[(356, 390), (np.int64(20), 121.0), (np.int64(181), 8.0)]",0.3333333333333333,0.9,3,0.75,1,3,4
509,"[(343, 60), (387, 27.0)]",0.5,2.0,2,0.0,2,1,3
510,"[(471, 1620), (86, 180), (29, 120), (np.int64(117), 99.0), (286, 60)]",0.6666666666666666,5.0,5,0.0,5,5,10
511,"[(310, 1170), (294, 540), (250, 420), (415, 232.0)]",1.0,3.6666666666666665,4,0.7391304347826086,4,4,8
512,"[(298, 5160), (277, 840), (72, 477.0), (493, 270)]",1.0,4.0,4,0.0,4,4,8
513,"[(142, 180)]",1.0,1.0,1,0.0,1,1,2
514,"[(237, 510), (404, 210), (204, 150), (np.int64(309), 78.0), (np.int64(327), 41.0)]",0.6,1.7999999999999998,3,0.6666666666666666,3,5,8
515,"[(116, 3030), (310, 2670), (121, 930), (138, 420)]",1.0,3.3333333333333335,4,0.0,4,4,8
516,"[(353, 60), (387, 53.0), (558, 30)]",0.3333333333333333,3.0,4,0.0,3,1,4
517,"[(305, 1786.0), (48, 863.0), (526, 240)]",1.0,3.0,3,0.0,3,3,6
518,"[(149, 360), (448, 360), (174, 356.0), (np.int64(96), 150.0)]",0.75,3.0,5,0.75,3,4,7
519,"[(284, 243.0), (480, 180), (242, 150), (168, 60)]",0.75,4.0,6,0.6666666666666666,4,3,7
520,"[(235, 330)]",1.0,1.0,1,0.0,1,1,2
521,"[(157, 3060), (np.int64(134), 40.0), (347, 38.0)]",0.6666666666666666,2.0,4,0.2777777777777778,2,3,5
522,"[(378, 930), (82, 250.0), (np.int64(255), 239.0)]",0.6666666666666666,2.0,3,0.0,2,3,5
523,"[(389, 269.0), (491, 240), (393, 60)]",1.0,3.0,3,0.3333333333333333,3,3,6
524,"[(33, 600), (315, 114.0)]",1.0,2.0,2,0.8,2,2,4
525,"[(3, 125.0), (134, 120), (315, 60)]",1.0,3.0,4,0.5,3,3,6
526,"[(474, 360), (517, 240)]",1.0,2.0,3,0.4,2,2,4
527,"[(360, 1980), (447, 510), (44, 320.0), (297, 90), (352, 36.0)]",0.6666666666666666,5.2682926829268295,6,0.0,6,4,10
528,"[(291, 300), (13, 36.0)]",1.0,2.0,2,0.5,2,2,4
529,"[(44, 120), (366, 90), (84, 60), (np.int64(98), 10.0), (np.int64(322), 7.0)]",0.6,3.0,5,0.0,3,5,8
530,"[(251, 3810), (120, 240), (np.int64(30), 90), (137, 78.0), (459, 24.0)]",0.6,3.68,5,0.0,4,4,8
531,"[(26, 180)]",1.0,1.0,2,0.0,1,1,2
532,"[(155, 360), (315, 150), (264, 120), (104, 105.0), (90, 43.0)]",0.5714285714285714,5.88235294117647,8,0.0,6,5,11
533,"[(189, 690)]",1.0,1.0,1,0.9,1,1,2
534,"[(261, 450), (188, 120.0), (np.int64(495), 67.0), (173, 29.0)]",0.5,3.0,5,0.875,3,3,6
535,"[(422, 2100), (161, 480), (271, 27.0), (144, 23.0)]",0.5,2.769230769230769,4,0.0,4,2,6
536,"[(480, 120)]",1.0,1.0,1,0.0,1,1,2
537,"[(79, 780), (232, 540), (137, 390)]",1.0,1.0,3,0.0,3,3,6
538,"[(101, 1500), (231, 90)]",1.0,0.0,2,0.6666666666666666,2,2,4
539,"[(88, 450)]",1.0,1.0,2,0.6666666666666666,1,1,2
540,"[(224, 1500), (346, 120), (467, 120)]",1.0,3.0,4,0.0,3,3,6
541,"[(435, 660), (119, 30)]",0.5,2.0,3,0.8888888888888888,2,1,3
542,"[(372, 30)]",0.0,1.0,1,0.0,1,0,1
543,"[(np.int64(312), 30)]",0.0,0.0,1,0.0,0,1,1
544,"[(190, 180)]",1.0,1.0,2,0.0,1,1,2
545,"[(410, 210)]",1.0,1.0,2,0.0,1,1,2
546,"[(170, 1770), (120, 1050), (394, 30)]",0.6666666666666666,2.25,3,0.8076923076923077,3,2,5
547,"[(440, 1320)]",1.0,1.0,2,0.0,1,1,2
548,"[(75, 1080), (145, 360)]",1.0,2.0,3,0.1,2,2,4
549,"[(207, 330), (np.int64(126), 30)]",0.5,1.0,3,0.0,1,2,3
550,"[(329, 450)]",1.0,1.0,1,0.0,1,1,2
551,"[(52, 1170), (325, 180), (np.int64(205), 30)]",0.6666666666666666,1.5,3,0.0,2,3,5
552,"[(182, 540), (265, 270), (98, 150)]",1.0,1.0,2,0.3333333333333333,3,3,6
553,"[(472, 90), (np.int64(208), 30)]",0.5,1.0,3,0.0,1,2,3
554,"[(373, 120), (np.int64(136), 30)]",0.5,1.0,3,0.0,1,2,3
555,"[(284, 630), (84, 600), (217, 120)]",1.0,3.0,5,0.0,3,3,6
556,"[(412, 210)]",1.0,1.0,1,0.0,1,1,2
557,"[(284, 300)]",1.0,1.0,2,0.0,1,1,2
558,"[(94, 120), (336, 90), (np.int64(516), 30)]",0.6666666666666666,2.0,4,0.0,2,3,5
559,"[(4, 960)]",1.0,1.0,1,0.6363636363636364,1,1,2
560,"[(397, 540)]",1.0,1.0,1,0.0,1,1,2
561,"[(348, 270), (48, 180), (378, 180)]",1.0,2.0,3,0.0,3,3,6
562,"[(139, 300)]",1.0,1.0,1,0.6666666666666666,1,1,2
563,"[(502, 780)]",1.0,1.0,1,0.875,1,1,2
564,"[(106, 930), (198, 420), (91, 90), (np.int64(408), 30)]",0.75,3.0,5,0.2727272727272727,3,4,7
565,"[(130, 540)]",1.0,1.0,2,0.0,1,1,2
566,"[(98, 450), (197, 30)]",0.5,2.0,3,0.0,2,1,3
567,"[(226, 540), (331, 120), (287, 90), (148, 60)]",1.0,4.0,4,1.0,4,4,8
